####################
#G|*********|**|E*P#
#*|*********|**|***#
#*|*********|**|***#
#*|*********|**|***#
#*|*********|**|***#
#*O---------O--O***#
#******************#
#*O-------O*O--O***#
#*****G****O***|***#
#E***GBG**E|G*G|**S#
####################