####################
#S****************G#
#*O---------------O#
#*|**************E*#
#*|*O------------O*#
#*|*|************|*#
#*|*|*O--------O*|*#
#*|*|*|BG**O---O*|*#
#***|*|G*EO******|*#
#***|*O----------O*#
#*P*OE*************#
####################