####################
#B***************EG#
#*O-**---O*****O***#
#*|*E***G|*****|***#
#*O-**---0*****|***#
#**********O---O***#
#**********|****O--O
#**********|***O**G#
#**********|***|***#
#*O-------*O***|***#
#E*************|S**#
####################